småprat=Webbchatten på Rollspel.nu
storprat=En sida som visar en stor småprat.
DoD,DochD=Drakar och Demoner, Sveriges första och största kommersiella rollspel.
DnD,D&D=Dungeons & Dragons, det äldsta och populäraste rollspelet i världen, från Wizards of the Coast.
BRP=Basic Roleplaying, en vanlig typ av rollspelsregler, används av Drakar och Demoner och Call of Cthulhu.
vrållåda=Gammalt namn på småpraten.
wrnu=Ett inofficiellt smeknamn på webbplatsen Rollspel.nu. Användes initialt enbart av redaktionen efter att någon omnämnde sidan som w.r.nu i kontakt med redaktionen.
GURPS=Generic Universal RolePlaying System, ett generiskt spelsystem från Steve Jackson Games.
fisktank=En scenariostruktur som lämpar sig väl för intriger och konfliktspelande, där spelarna måste ta ställning i vad de vill göra.
plantering=Plantering är när spelledaren etablerar någonting i handlingen men dess nytta skördas först senare.
skörda=Återkoppla till något som "planterats" tidigare i scenariot.
rälsar=Rälsar är äventyr sorterade efter kronologisk ordning. 
samberättande=Spelarna beskriver i varierande grad världen och handlingen även bortom deras rollpersoners förmågor, något som annars är reserverat till spelledaren.
narrativism=Påminner om den ursprungliga definitionen av Samberättande, men förutsätter också att spelarna söker svar på en premiss.
narrativt=Ett rollspel eller en spelledar- och spelarstil som verkar för att skapa en så intressant historia som möjligt.
rollspelsteori=Att analysera ett spel och dess strukturer, och vad detta leder till i praktiken, sätta upp designmål.
progressiva rollspel=Rollspel som gör något få eller inga rollspel har gjort förut.
forgespel=Spel utvecklade i diskussion på, eller representerade med egna forum på www.indie-rpgs.net
nischning=En gradskala på hur inriktade på en specifik spelstil ett spels tema och strukturer är. Strukturer innefattar hur spelvärlden presenteras, regler, exempel, spelledar- och spelarinstruktioner.
setting,ramverk,Kuliss,Miljö,Stämning=Ramverket, kulisserna, stämningsättare, miljön och känsla.
berättelsen=Berättelsen är det som skapas under spelmötet när spelarna genom sina huvudpersoner reagerar på de improviserade eller förberedda situationer berättaren lägger fram.
persson=En underbar skapelse som finns till för andras beundran. Årets forumspersonlighet 2010.
trad,tradspel,Tradrollspel=Traditionella spel som Mutant, Drakar och Demoner, Eon och Dungeons & Dragons. Se även "indiespel".
Indie,Indiespel=Indiespel har två tydliga riktningar som skiljer dem från traditionella rollspel: spelardeltagande och berättelsefokus. Se http://www.rollspel.nu/forum/ubbthreads.php/posts/683082.html för mer information om detta.
relationskarta=En tankekarta där spelledaren lätt kan se vilka som står i relation till andra, exempelvis vem som mördat vem, vem som ogillar vem etc.
simulationism=Spelstil som fokuserar på simulera en viss genre, ofta med en realistisk ton.
gamism=Spelstil som fokuserar på taktiska utmaningar.
GNS=En del av forgeteorin The Big Model. GNS står för gamism, narrativism och simulationism. Teorin ska underlätta för spelmakare i vilket ett spels nischning ska ha.
big model,tbm,The Big Model=Teori för skapandet av ett rollspel. Se Genesis TBM-skola: http://www.rollspel.nu/forum/ubbthreads.php/ubb/showflat/Number/664218/
The Forge,Forge=En community för skapande av indiespel.
fortune-in-the-middle,FitM=Att kunna påverka utgången av ett tärningsslag efter att det har gjorts. Jämför med Fortune-in-the-end.
spelarinflytande=När spelarna har makten att påverka scenariot och världen utöver vad de kan göra med sin rollperson. Exempelvis hitta på saker i miljön, hitta på plotelement, hitta på bekanta till rollpersonen, bidra med rykten eller på annat sätt utöka världsinformationen med mera.
fortune-in-the-end,FitE=I vilket skede man slår tärningen. Att först beskriva handlingen, göra modifikationer, använda förmågor och slutligen slå tärningsslaget för att se om personen lyckas.
Konvention=Regler som handlar mer om att sätta rätt spelstil än regelmekanik. Exempel: hur ofta man ska slå tärningarna, råd över vem som får beskriva miljö och handlingar med mera.
bomb=En laddad situation där en rollperson måste reagera på något sätt, till och med att inte göra något är ett ställningstagande. Ofta någon form av dilemma som berör en av rollpersonens flaggor.
djupimmersionism=Djupimmersionismen är en rollspelsinriktning där deltagarna strävar efter så total inlevelse, eller immersion, i sina rollpersoner som möjligt. Idealtillståndet anses vara det där spelarens personlighet helt och hållet undertryckts till förmån för rollpersonens.
flaggor,flagga=Någonting som är viktigt för rollpersonen och något som spelaren är intresserad av att se mer av i spelet, exempelvis en talang, ett ideal, en önskan med mera. En rollpersons flagga kan nå klimax i spelet genom en bomb.
kicker=En enskild händelse/företeelse/situation som inleder scenariot och involverar rollpersonen på något sätt.
krok=En händelse, företeelse eller situation som krokar fast rollpersonen i scenariot. Både en flagga och en kicker är en krok.
vang=En laddad situation där en rollperson måste reagera på något sätt, till och med att inte göra något är ett ställningstagande. Ofta någon form av dilemma som berör en av rollpersonens flaggor.
Matiné=Ett swashbucklingrollspel från 2009 där man uppnår actionfyllda strider genom att förändra sin spelstil så att spelarna får mer inflytande i vad de får hitta på i miljön.
HALiBot=En artificiell intelligens som kommer att ta över världen när du minst anar det
hoahoa=Lennart "Hoa-Hoa" Dahlgren kommenterade wrestling med Bruno Arvidsson under 90-talet. Med kommandot !hoahoa får du citat från den perioden. Annars känd för sina elva SM-medaljer i tyngdlyftning.
skiftning=Att flytta handlingsbärande element så att spelarna alltid kommer att trilla på dem. Exempel: det spelar ingen roll om spelarna går till huset eller kyrkogården. De kommer att hitta samma ledtråd ändå.
neotrad=Spel som utgår från traditionella rollspel men som hämtat influenser ifrån indiespelen.
spökvrål=När det blir dubbla meddelanden i Småpraten. Ingen annan förutom sändaren ser denna dublett.
månvrål=När personen svarar på ett meddelande som skrivits för länge sedan. Detta sker ofta när Småpraten har slutat uppdateras, vilket kan ske om chatten är öppen väldigt länge utan att användaren skriver någonting själv.
grokka=att ha en fundamental och naturlig förståelse för något. Att kunna "känna" det.
emergens=den upplevelse som framträder när ett spels olika regler och annan information börjar interagera och användas ihop med varandra.
D20=Ett regelsystem tillverkat av Wizards of the Coast, med förhållandevis öppen licens vilket gjort att många speltillverkare kunnat använda systemet.
trad=Traditionella spel som Mutant, Drakar och Demoner, Eon och Dungeons & Dragons. Se även "indiespel".
Kraetyz=Den där underliga utväxten i din armhåla. Fast med mer slem.
scen=En scen utspelar sig på en plats under en begränsad period. En scen byter till en annan om rollpersonerna går till en annan plats eller när en längre tid förflyter.
metaspelande=När en spelare använder sig av information som rollpersonen inte borde besitta, exempelvis data om ett monster, hur ett äventyr normalt är upplagt eller information som framkommit när rollpersonen
OT=Off topic. När ämnet i ett inlägg har frångått det trådstarten handlade om.
Storuggla=Se OT.
NT=No text. Används när ämnesraden räcker för en kort kommentar. Ingen text behövs i inlägget.
gelemässig=En forumsklassiker. Felskrivning på ordet regelmässig.
ålfiske,ålfiskning=Spelledaren beskriver detaljerat. Termen kommer från en legendarisk diskussionsduell mellan Krille och Rising.
dockskåp,dockskåpsfantasy=Termen syftar till att dessa världar blir som ett litet 'dockskåp' för spelledaren att pilla med.
prestationsspel=Spel som baserar sig på utmaningar som rollpersonerna skall prestera sig förbi.
bastardtärning,bastardtärningar=Bastardtärningar är oäkta tärningar. Hälften tärning, hälften tabell som T3 och T5.
Gardener=En kaffemaskinsmoddande liten farbror i sina bästa år.
Han=En god rollspelsmakare med sinne för effektivitet. Numera emigrerad till Australien där han odlar dingos och nostalgitrippar på Drakar & Demoner.
DeBracy=Mysigt lurvig skäggbjörn med förkärlek till old school fantasy, NWOBHM och god mat.
Czege,Czegeprincip,Czegeprincipen=Principen säger att det inte är kul om samma spelare hittar på problemet och överkommer det.
Chekov,Chekovs Gun,Chekov’s gun=Ett element som blivit planterat i ett scenario måste skördas senare, annars borde elementet inte varit där i första fallet.
postdancontrauma=Direkt efter ett avslutat DanCon framstår en vanlig arbetsdag som EXCEPTIONELLT tråkig och alldaglig.
lapptäcksvärld,lapptäcksvärldar=Världar (främst fantasy) där det skiljer stort mellan olika länder/kulturers teknologiska framsteg. T.ex. att det i ett land bor typiska medeltidsriddare och i landet bredvid bor typ romerska
nallovania=Benämning på en sorts extrem lapptäckesvärld, utan tillstymmelse till förklaring till de grava skillnaderna mellan länder och områden.
taprant=En häftig idé men som är omöjlig att genomföra.
mook=En obetydlig och lätt fiende i spelet Feng Shui. Samma betydelse som minion i D&D4. Kommer ursprungligen från ordet mook jong som är trädockan som man tränar med i kampsport.
solvebring=En tänkare med gott hjärta och en påse sömnlöshet.
PlusS=Någon som försöker lista ut kommandon i vrållådan.
RealDream=En falsk dröm.
vråleko=När det blir dubbla meddelanden i Småpraten. Alla förutom avsändaren ser dubletten. Se även »spökvrål«,
pudelutställning=När spelledaren ger belöning utifrån spelarna bedrifter, likt pudlar som bedöms av en domare. Detta gör att spelarna beskriver vad spelledaren vill istället för vad de själva vill.
pudelpoäng=XP- eller andra problemlösningsbonusar för gott rollgestaltande. Om problemlösningsmomenten stjäl tid och ork från rollgestaltandet, varför då belöna rollgestaltande med poäng man enbart eftersträvar som problemlösare?
